name	title	coding
t3_qlfnzk	Cloudberry (+ Tri-pawed squirrel) Appreciation Post	o
t3_qnf5hq	Struggling with COMP 302	c
t3_qmndra	Comment on OSD exams?	o
t3_ql6jp4	Best Place to cry on campus?	o
t3_qm8ce9	How good/bad does a 3.2 gpa look on a CV?	o
t3_qm6u9q	Failing COMP310 with Muhesh, what do ?	c
t3_qkusbu	Switching majors from BIOC to MIMM major	o
t3_qmjkjk	Problem with lecture recordings	c
t3_ql4v1e	Neurologist in Montreal	o
t3_qks66s	Best places for small food + studying around campus?	f
t3_ql9qjj	has anyone ever washed their student card lol	o
t3_qmeg1f	Is there a club for conservative students?	o
t3_qmadu3	Is this academic fraud or is it okay?	o
t3_ql7tns	Withdrawing from a course and mycourses	c
t3_qltp0b	Struggling first year	o
t3_qm0646	Psyc 395	c
t3_qm8tjk	Comp535 midterm 2	c
t3_qljnla	Breaking a lease over a persistent cockroach infestation?	o
t3_qm9bs9	good, cheap plant stores!	o
t3_ql6ux7	What happens if I fail a required course twice?	c
t3_qmn9u7	If you have a dog in the Plateau beware of 2 women with a large poodle(?)	o
t3_qncnpo	Question about Richard Roy	o
t3_qleztt	Transferring to neuroscience	o
t3_qm6dz8	Help! I’m running out of meals to make myself	f
t3_qn2sji	REAL TALK FRIDAY	o
t3_qm3vyp	Thoughts on taking Mech 383 in U1	c
t3_qmxg3q	seeing a dermatologist as an intl student	o
t3_qlxgan	Places to eat in Griffintown?	f
t3_ql5q2w	Asking for reference letters for grad school	o
t3_qmim0k	Guy on Sherbrooke asking for Money	o
t3_qlbf2t	COMP 202 vs 204	c
t3_qlefrj	It’s so awkward being poor	o
t3_ql9brj	Comp251 Midterm	c
t3_qlbi8a	There’s a lot of apparent sadness on this page. Anyone been happy as hell lately (or pretty happy at least)?	o
t3_qm0slu	Math 556 midterm: thoughts ?	c
t3_qm47sr	Candidate to Engineering Profession Application with the OIQ	o
t3_qlqwk9	Is Neuroscience interesting?	o
t3_qmc0og	Skateboarders of MCGILL...where you at???	o
t3_qmt2hq	Can you talk in the Redpath floor 2 pods?	o
t3_qldqqm	Weird Feeling Coming Back	o
t3_qld6e8	Sending Transcripts before application	o
t3_qlll1j	Best nachos around campus?	f
t3_qn8xww	Hot water on campus?	o
t3_qlhftr	Late withdrawal from 2 courses- please help!	c
t3_qkvkce	Is there anyway to get ethernet or my own stable internet connection in my room on campus? (residence)	r
t3_qloppc	Principles of Toxicology! Help!	c
t3_qmb4t2	PSYC 302	c
t3_qmsh3a	Do I need to retake a course I get a J in if it’s just an elective?	c
t3_qlge44	Can I get my grad picture taken after I graduate?	o
t3_qn4wz0	Orthodontist for International student	o